###############
#...B.........#
#.............#
#.......A.....#
#...C.........#
#.............#
#.............#
#............^#
###############